1111111111111111111111111111111111111111
1000000000C0000000000C0000C0000000000E01
1000P00000000000C00000000000000C00000001
1111111111111111111111111111111111111111
