1111111
100C001
10E0011
1000011
10C0011
1P00111
1111111
